R 600 480
NO ./textures/north.xpm
SO ./textures/south.xpm
WE ./textures/west.xpm
EA ./textures/east.xpm
S ./textures/sprites.xpm
F 220,100,0
C 225,30,0

          111111
1111111111122221111111111
1000000000000000000000001
1000000000000000000000001
1000000000000000000000001
1000000000000000000000001
1000000000000220000000001
1000000000000000000000001
1000000000000000000000001
1000000000000000000N00001
1000000000000000000000001
1111111111111111111111111