R 600 480
NO ./textures/north1.xpm
SO ./textures/south1.xpm
WE ./textures/west1.xpm
EA ./textures/east1.xpm
S ./textures/sprites.xpm
M ./textures/monster.xpm
F 60,60,60
C 160,160,160

11111111111111111111111111111
10000000000000000000000000001
10000000000000000000000000001
10000000002222220000000000001
10000000001111110000000000001
10000000000000000000000000001
1000000000000N000000000000001
10000000000000000000000000001
11111111111111111111111111111