R 600 480
NO ./textures/north1.xpm
SO ./textures/south1.xpm
WE ./textures/west1.xpm
EA ./textures/east1.xpm
S ./textures/sprites.xpm
F 60,60,60
C 160,160,160

11111111111111111111111111111
10000000001100000000000000221
10110000011100000000000010001
10010000000000222222220010001
10110000011100000000000010011
10000000001100000111011110001
11110111111111011100000010001
11110111111111011101010010001
11000000110101011100000010001
10000000000010101100000010001
10000000020000001101010010001
10000000000000001101010010N01
11000000110101011111011110001
11110111111101011111011110001
11111111111111111111111111111
10000000000000001100000010001
10000000000000001101010010001
11111111111111111111111111111