R 600 480
NO ./textures/north.xpm
SO ./textures/south.xpm
WE ./textures/west.xpm
EA ./textures/east.xpm
S ./textures/sprites.xpm
F 220,100,0
C 225,30,0

11111111
10000001
10000001
10000001
10000001
10000001
10000001
10000001
10000001
10000001
10000001
10000001
10000001
11111111
11111111111111111111111111111
10000000001100000000000000001
10110000011100000010000010001
10010000000000100000000010001
10110000011100000100000010011
10000000001100000111011110001
11110111111111011100000010001
11110111111111011101010010001
11000000110101011100000010001
10001000000000001100000010001
1000000000N000001101010001001
10000000000000001101010010001
11000000110101011111011110001
11110111111101011111011110001
11111111111111111111111111111
10001000000000001100000010001
10000000000000001101010010001
11111111111111111111111111111