R 1200 600
NO ./textures/north1.xpm
SO ./textures/south1.xpm
WE ./textures/west1.xpm
EA ./textures/east1.xpm
S ./textures/sprites.xpm
M ./textures/monster.xpm
B ./textures/health.xpm
L ./textures/life_bar.xpm
G ./textures/gun.xpm
F 60,60,60
C 160,160,160

11111111111111111111111111111
10000000040000000000000000001
11111111111111111111111000001
                      1000001
                      1000001
                      1000001
                      1000001
1111111111111111111111100000111111111111111
1000000000024200000000000000000030000000001
1000000000000000000000000000000000000300001
1000000300000000000000300000000030000000001
1000000000000000000000000000111111111111111
1000000000000N000000000000001
10242000000000000000000000001
11111111111111111111111000001
                      1000001
              111111111000001
11111111111111100003000000001
10000000000000000000000003001
10000000000000111111111100001
100200020000001        100001
111111111111111        111111