R 301 301
NO ./textures/north1.xpm
SO ./textures/south1.xpm
WE ./textures/west1.xpm
EA ./textures/east1.xpm
S ./textures/sprites.xpm
F 60,60,60

C 160,160,160


1111111111111111111111111111111111111111111
1000002002000020000000000000000000000000001
1000000000000000000000000000000000000000001
1000000000000000000000000000000000000000001
1000000000000000000000000000111111111111111
1000000000000000W000000000001
10000000000000000000000000001
11111111111111111111111111111