R 600 480
NO ./textures/north1.xpm
SO ./textures/south1.xpm
WE ./textures/west1.xpm
EA ./textures/east1.xpm
S ./textures/sprites.xpm
F 60,60,60
C 160,160,160

11111111111111111111111111111
10000000000000000000000000001
11111111111111111111111000001
                      1000001
                      1000001
                      1000001
                      1000001
1111111111111111111111100000111111111111111
1000000000020200000000000000000000000000001
1000000000000000000000000000000000000000001
1000000000000000000000000000000000000000001
1000000000000000000000000000111111111111111
10000000000000000000000000001
10202000000000000000000000001
11111111111111111111111000001
                      1000001
              111111111000001
11111111111111100000000000001
10000000000000000000000000001
10000000000000111111111100001
100200020000001        100001
111111111111111        111111
1   1
11111
10001
10001
10N01
10001
11111