1111111111111111
1000000000000001
100000000000000111111111111
1000000000000000000000000001
100000000000000111111111111
1000000000000000000111
10000000000000000000001
1000000000000000000111111111111111111111
1111100000000000001111111110011110000001
11111111111111111111 1111111111  1111111     