R 1920 1080
NO ./textures/north.xpm
SO ./textures/south.xpm
WE ./textures/west.xpm
EA ./textures/east.xpm
S ./textures/sprites.xpm
F 220,100,0
C 225,30,0

        1111111111111111111111111
        1000000000110000000000001
        1011000001110000002000001
        1001000000000000000000001
111111111011000001110000000000001
100000000011000001110111111111111
11110111111111011100000010001
1111011111111101111011110001111
1100000011010101110N01101000001
1000200000000000110000101000111
10000000000000001101010010001
110000011101010111110111100111
11111111 1111111 111111111111